{
    "maze": [
        ["1", "1", "1", "1", "1", "1", "1", "1", "1", "1", "1", "1", "1", "1", "1", "1", "1", "1", "1", "1", "1"],
        ["1", "3", "1", "0", "0", "0", "0", "0", "0", "0", "1", "0", "0", "0", "0", "0", "0", "0", "0", "0", "1"],
        ["1", "0", "1", "0", "1", "0", "1", "1", "1", "0", "1", "1", "1", "1", "1", "0", "1", "1", "1", "0", "1"],
        ["1", "0", "1", "0", "1", "0", "0", "0", "1", "0", "0", "0", "0", "0", "1", "0", "0", "0", "1", "0", "1"],
        ["1", "0", "1", "1", "1", "1", "1", "0", "1", "1", "1", "1", "1", "0", "1", "1", "1", "0", "1", "0", "1"],
        ["1", "0", "0", "0", "0", "0", "0", "0", "1", "0", "0", "0", "1", "0", "1", "0", "0", "0", "1", "0", "1"],
        ["1", "1", "1", "1", "1", "1", "1", "1", "1", "0", "1", "0", "1", "0", "1", "0", "1", "1", "1", "0", "1"],
        ["1", "0", "0", "0", "0", "0", "1", "0", "0", "0", "1", "0", "0", "0", "1", "0", "0", "0", "1", "0", "1"],
        ["1", "0", "1", "0", "1", "1", "1", "0", "1", "1", "1", "1", "1", "1", "1", "1", "1", "1", "1", "0", "1"],
        ["1", "0", "1", "0", "0", "0", "0", "0", "1", "0", "0", "0", "0", "0", "0", "0", "0", "0", "0", "0", "1"],
        ["1", "0", "1", "1", "1", "1", "1", "1", "1", "0", "1", "0", "1", "1", "1", "1", "1", "1", "1", "0", "1"],
        ["1", "0", "1", "0", "0", "0", "1", "0", "0", "0", "1", "0", "1", "0", "0", "0", "0", "0", "1", "0", "1"],
        ["1", "0", "1", "0", "1", "0", "1", "0", "1", "0", "1", "1", "1", "0", "1", "1", "1", "0", "1", "1", "1"],
        ["1", "0", "1", "0", "1", "0", "1", "0", "1", "0", "0", "0", "0", "0", "0", "0", "1", "0", "0", "0", "1"],
        ["1", "0", "1", "0", "1", "1", "1", "0", "1", "1", "1", "1", "1", "1", "1", "1", "1", "1", "1", "0", "1"],
        ["1", "0", "1", "0", "0", "0", "0", "0", "1", "0", "0", "0", "0", "0", "1", "0", "0", "0", "1", "0", "1"],
        ["1", "0", "1", "1", "1", "1", "1", "1", "1", "0", "1", "1", "1", "0", "1", "0", "1", "0", "1", "0", "1"],
        ["1", "0", "0", "0", "0", "0", "0", "0", "1", "0", "1", "0", "1", "0", "1", "0", "1", "0", "0", "0", "1"],
        ["1", "1", "1", "1", "1", "1", "1", "0", "1", "0", "1", "0", "1", "0", "1", "0", "1", "1", "1", "0", "1"],
        ["1", "0", "0", "0", "0", "0", "0", "0", "0", "0", "1", "0", "0", "0", "0", "0", "1", "0", "0", "2", "1"],
        ["1", "1", "1", "1", "1", "1", "1", "1", "1", "1", "1", "1", "1", "1", "1", "1", "1", "1", "1", "1", "1"]
    ],
    "width": 21,
    "height": 21,
    "start_coords": [1, 1],
    "end_coords": [19, 19],
    "stats": []
}