{
    "maze": [
        ["1", "1", "1", "1", "1", "1", "1", "1", "1", "1", "1", "1", "1"],
        ["1", "3", "1", "0", "0", "0", "0", "0", "0", "0", "0", "0", "1"],
        ["1", "0", "1", "0", "1", "1", "1", "1", "1", "1", "1", "0", "1"],
        ["1", "0", "1", "0", "0", "0", "0", "0", "1", "0", "0", "0", "1"],
        ["1", "0", "1", "0", "1", "1", "1", "0", "1", "1", "1", "0", "1"],
        ["1", "0", "1", "0", "0", "0", "1", "0", "0", "0", "1", "0", "1"],
        ["1", "0", "1", "1", "1", "1", "1", "1", "1", "0", "1", "1", "1"],
        ["1", "0", "1", "0", "0", "0", "0", "0", "1", "0", "0", "0", "1"],
        ["1", "0", "1", "0", "1", "1", "1", "0", "1", "1", "1", "0", "1"],
        ["1", "0", "0", "0", "1", "0", "1", "0", "1", "0", "0", "0", "1"],
        ["1", "1", "1", "1", "1", "0", "1", "0", "1", "0", "1", "0", "1"],
        ["1", "0", "0", "0", "0", "0", "0", "0", "0", "0", "1", "2", "1"],
        ["1", "1", "1", "1", "1", "1", "1", "1", "1", "1", "1", "1", "1"]
    ],
    "width": 13,
    "height": 13,
    "start_coords": [1, 1],
    "end_coords": [11, 11],
    "stats": []
}